"filename", "language", "PHP", "comment", "blank", "total"
"c:\xampp\htdocs\SurgeryAndWound\admin\admin-add.php", "PHP", 106, 4, 17, 127
"c:\xampp\htdocs\SurgeryAndWound\admin\admin-export.php", "PHP", 112, 0, 10, 122
"c:\xampp\htdocs\SurgeryAndWound\admin\admin-upload.php", "PHP", 249, 32, 33, 314
"c:\xampp\htdocs\SurgeryAndWound\admin\admin-upload2.php", "PHP", 246, 19, 33, 298
"c:\xampp\htdocs\SurgeryAndWound\admin\admin.php", "PHP", 72, 0, 3, 75
"c:\xampp\htdocs\SurgeryAndWound\admin\appointment-add.php", "PHP", 154, 14, 19, 187
"c:\xampp\htdocs\SurgeryAndWound\admin\appointment-excel-add.php", "PHP", 223, 14, 38, 275
"c:\xampp\htdocs\SurgeryAndWound\admin\appointment-list.php", "PHP", 103, 0, 7, 110
"c:\xampp\htdocs\SurgeryAndWound\admin\doctor-add.php", "PHP", 88, 278, 6, 372
"c:\xampp\htdocs\SurgeryAndWound\admin\excel.php", "PHP", 91, 1, 18, 110
"c:\xampp\htdocs\SurgeryAndWound\admin\includes\adm_conn.php", "PHP", 244, 21, 58, 323
"c:\xampp\htdocs\SurgeryAndWound\admin\includes\path.inc.php", "PHP", 137, 10, 28, 175
"c:\xampp\htdocs\SurgeryAndWound\admin\includes\session.inc.php", "PHP", 14, 1, 5, 20
"c:\xampp\htdocs\SurgeryAndWound\admin\index.php", "PHP", 106, 12, 6, 124
"c:\xampp\htdocs\SurgeryAndWound\admin\layouts\404.php", "PHP", 124, 5, 24, 153
"c:\xampp\htdocs\SurgeryAndWound\admin\layouts\nav_header.php", "PHP", 30, 0, 0, 30
"c:\xampp\htdocs\SurgeryAndWound\admin\layouts\navigate.php", "PHP", 65, 0, 0, 65
"c:\xampp\htdocs\SurgeryAndWound\admin\layouts\widget.php", "PHP", 81, 0, 1, 82
"c:\xampp\htdocs\SurgeryAndWound\admin\login.php", "PHP", 48, 10, 11, 69
"c:\xampp\htdocs\SurgeryAndWound\admin\logout.php", "PHP", 8, 0, 0, 8
"c:\xampp\htdocs\SurgeryAndWound\admin\not_needed\admin-export2.php", "PHP", 42, 0, 9, 51
"c:\xampp\htdocs\SurgeryAndWound\admin\not_needed\admin-upload2.php", "PHP", 161, 5, 21, 187
"c:\xampp\htdocs\SurgeryAndWound\admin\not_needed\appointment.php", "PHP", 81, 0, 2, 83
"c:\xampp\htdocs\SurgeryAndWound\admin\not_needed\clinic-add.php", "PHP", 177, 68, 23, 268
"c:\xampp\htdocs\SurgeryAndWound\admin\not_needed\clinic-edit.php", "PHP", 366, 5, 35, 406
"c:\xampp\htdocs\SurgeryAndWound\admin\not_needed\clinic-list.php", "PHP", 88, 0, 2, 90
"c:\xampp\htdocs\SurgeryAndWound\admin\not_needed\clinic-view.php", "PHP", 146, 1, 6, 153
"c:\xampp\htdocs\SurgeryAndWound\admin\not_needed\doctor-add.php", "PHP", 137, 275, 20, 432
"c:\xampp\htdocs\SurgeryAndWound\admin\not_needed\doctor-list.php", "PHP", 75, 0, 3, 78
"c:\xampp\htdocs\SurgeryAndWound\admin\not_needed\doctor-view.php", "PHP", 339, 0, 27, 366
"c:\xampp\htdocs\SurgeryAndWound\admin\not_needed\patient-assign2.php", "PHP", 123, 2, 18, 143
"c:\xampp\htdocs\SurgeryAndWound\admin\not_needed\patient-list.php", "PHP", 75, 0, 3, 78
"c:\xampp\htdocs\SurgeryAndWound\admin\not_needed\patient-view.php", "PHP", 339, 0, 27, 366
"c:\xampp\htdocs\SurgeryAndWound\admin\not_needed\speciality.php", "PHP", 87, 199, 10, 296
"c:\xampp\htdocs\SurgeryAndWound\admin\patient-add.php", "PHP", 88, 281, 7, 376
"c:\xampp\htdocs\SurgeryAndWound\admin\patient-assign.php", "PHP", 144, 2, 16, 162
"c:\xampp\htdocs\SurgeryAndWound\admin\patient-doctor-list.php", "PHP", 128, 0, 6, 134
"c:\xampp\htdocs\SurgeryAndWound\admin\patient-doctor-view.php", "PHP", 496, 0, 39, 535
"c:\xampp\htdocs\SurgeryAndWound\admin\patient-edit-view.php", "PHP", 341, 362, 30, 733
"c:\xampp\htdocs\SurgeryAndWound\admin\profile.php", "PHP", 189, 12, 20, 221
"c:\xampp\htdocs\SurgeryAndWound\admin\research_team-add.php", "PHP", 274, 19, 35, 328
"Total", "-", 6197, 1652, 676, 8525